######
#S==E#
#=##=#
#====#
######