################
#S==#E######
#=###=##########
#=====##########
################